######
#     #
# .o@ #
#     #
######